% = = = = = = = = = = = &
! o o o o o o o o o o o !
! o % = = = & o o % & o !
! o ! o o o ! o o L # o !
! o ! o < u # o o o o o !
! o ! o o v o o o o o o !
! o ! o o o o o o o o o !
! o L = = = = = > o < = r
! o o o o o o o o o o o !
L = = = = = = = = = = = #