# # # # # # # # # # # # # # # # # # # #
# o o o o o o o o o o o o O O O o o o #
# o # # # # # # # o o o o o o o o o o #
# o o o o o o o # o o o o o o o o o o #
# o # # o # o o o o o o o o o o o o o #
# o o o o o o o # o o o o o o o o o o #
# o # # # # # # # o o o o o o o o o o #
# o o o o o o o o o o o o o o o o o o #
# o o o o o o o o o o o o o o o o o o #
# o o o o o o o o o o o o o o o o o o #
# o o o o o o o o o o o o o o o o o o #
# o o o o o o o o o o o o o o o o o o #
# o o o o o o o o o o o o o o o o o o #
# o o o o o o o o o o o o o o o o o o #
# o o o o o o o o o o o o o o o o o o #
# o o o o o o o o o o o o o o o o o o #
# o o o o o o o o o o o o o o o o o o #
# o o o o o o o o o o o o o o o o o o #
# o o o o o o o o o o o o o o o o o o #
# # # # # # # # # # # # # # # # # # # #
